establishmentmeans	standard	vetted
?	unknown	1
ACCIDENTAL TRANSPORT	introduced	1
CAPTIVE	managed	1
CULTIVATED	managed	1
DOMESTIC	managed	1
DOMESTIC?	unknown	1
DOMESTICATED	managed	1
EM		1
ESCAPED FROM CAPTIVITY	introduced	1
HUMAN DEPOSITION	human deposition	1
INVASIVE	invasive	1
MANAGED	managed	1
NATIVE	native	1
NATIVO	native	1
PURCHASED	unknown	1
UNCERTAIN	unknown	1
UNKNOWN	unknown	1
WILD	native	1
WILD CAUGHT	native	1
